000000000000000000000000000000000000000000000000000000000000000000000000000000000000000000000000000000000000000000000000
000000000000000000000000000000000000000000000000000000000000000000000000000000000000000000000000000000000000000000000000
000000000000000000004547000000000000000000000000000000000000000000000000000000000000000000000000000000000000000000000000
040202040401040000000000000000000000000000000000000000000000000000000000000000000000000000000000000000000000000000000000
818181818181820000000000000045470000000000000000000000000000000000000000000000000000000000000000000000000000000000000000
a1a1a1a1a1a1a20000000000000000000000000000000000000000000000000000000000000000000000000000000000000000000001040103040304
000000000000000000000000000000000000000000000000000000000000000000000000000000000000000000000000000000000080818181818181
0000000000000000000045464646464646464646464646464646464646464700000000000000000000000000000000000045464647a0a1a1a1a1a1a1
000000000202000000000000000000000000000000000000000000000000000000000000000000000000000000000000000000000000000000000000
010000008082010000004546464700000000000000000000000000000000000000000201020402040103030102040201000000000000000000000000
a40000009093820301000000000000000000000000000000000000000000000000008081818181818181818181818182454646464646464646464647
00000000909193818202020000000000000000454646464646470000000000000000a0a1a1a1a1a1a1a1a1a1a1a1a1a2000000000000000000000000
024546479091919193818204020000000000000000000000000000000000000000000000000000000000000000000000000000000000030301020402
820000009091919191919381820000000000000000000000000000000000000000000000000000000000000000000000000000000000808181818181
a2454647a0a1a1a1a1a1a1a1a20000000000000000000000000000000000000000000000000000000000000000000000000000000000a0a1a1a1a1a1
000000000000000000000d00000000000000000000000000000000000000000000000000000000000000000000000000000000000000000000000000
004546470000000000001d00000000000000000000000000000000000000000000000000000000000000000000000000000000000000000000000000
000000000000000000001d00004546464646464646464647000000000000000000000000000000000000000000000000000000000000000000000000
004546470000000301032d03030000000000000000000000000000000000000000000000000000000000000000000000000000000000000000000000
000000000000008081818181820100000000000000000000000000004546464647000000000000000000000000000000000000000000000000000000
000000000404049091919191938200000000000000000000000000000000000000000000000000000000000404040203020000000000000302010102
0000000080818194919191919192b0b1b200000000000000000000000000000000000000808200000000008081818181820000000000008081818181
00000000a0a1a1a1a1a1a1a1a1a2c0c1c205050505b0b1b2000000000000000000000000a0a20606060606a0a1a1a18492040000000000a0a1a1a1a1
b1b1b1b1b1b1b1b1b1b1b1b1b1b1c4c1c3b1b1b1b1c4c1c20000000000000000000000b0b1b1b1b1b1b1b1b1b1b1b29093820000000000000d000000
c1c1c1b3d1d1d1d1d1d1d1d1d1d1d1d1d1d1d1d1d1d1b4c2e5e600000000000000e3e4c0b3d1d1d1d1d1d1d1d1b4c29091920300000000001d000000
c1c1c1c2101010101010101010101010101010101010c0c2f5f600000000000000f3f4c0c22020202020202020c0c29091938200000000001d000000
c1c1c1c2101007081010101007081010101007081010d0d20000000002040400000000d0d22020202020202020c0c29091919203000000001d000000
c1c1c1c21010171815161010171813141010171811121010000000018081820300000020202020203031323334c0c29091919382010000001d000000
c1c1c1c21010272825261010272823241010272821221010040101809491938202030420202020204041424344c0c29091919193820404042d030104
c1c1c1c2e0e1e1e1e1e1e1e1e1e1e1e1e1e1e1e1e1e1e1e28081819491919193818182e0e1e1e1e1e1e1e1e1e2c0c290919191919381818181818181

song toottoot
door 18 27 2 2 101 3 9
door 12 27 2 2 201 3 9
door 6 27 2 2 301 3 9
edgedoor w 14 10 2 -14
hero 29 26
