000000000000000000000000000000000000000000000000000000000000000000000000000000000000000000000000000000000000000000000000
000000000000000000000102000000000000000000000000000000000000000000000000000000000000000000000000000000000000000000000000
00000000000000000000a4a4000000000000000000000000000000000000000000000000000000000000000000000000000000000000000000000000
040202040401040000000000000001010000000000000000000000000000000000000000000000000000000000000000000000000000000000000000
8181818181818200000000000000a3a40000000000000000000000000000000000000000000000000000000000000000000000000000000000000000
a1a1a1a1a1a1a20000000000000000000000000000000000000000000000000000000000000000000000000000000000000000000001040103040304
000000000000000000000004040201040201020403010103010401030102030000000000000000000000000000000000000000000080818181818181
0000000000000000000000a4a4a3a4a4a4a3a4a4a4a4a4a3a3a3a3a4a3a3a300000000000000000000000000000000000000000000a0a1a1a1a1a1a1
000000000202000000000000000000000000000000000000000000000000000000000000000000000000000000000000000000000000000000000000
010000008082010000000000000000000000000000000000000000000000000000000201020402040103030102040202000000000000000000000000
a30000009093820302000000000000000000000000000000000000000000000000008081818181818181818181818182000000000000000000000000
00000000909193818201040000000000000000000000000000000000000000000000a0a1a1a1a1a1a1a1a1a1a1a1a1a2000000000000000000000000
040402029091919193818204020000000000000000000000000000000000000000000000000000000000000000000000000000000000030301020402
818181819491919191919381820000000000000000000000000000000000000000000000000000000000000000000000000000000000808181818181
a1a1a1a1a1a1a1a1a1a1a1a1a20000000000000000000000000000000000000000000000000000000000000000000000000000000000a0a1a1a1a1a1
000000000000000000000000000000000003040203020000000000000000000000000000000000000000000000000000000000000000000000000000
000000000000000000000000000000000080818181820000000000000000000000000000000000000000000000000000000000000000000000000000
0000000000000000000000000000000000a0a1a1a1a20000000000000000000000000000000000000000000000000000000000000000000000000000
000000000000000000030103040000000000000000000000000000000000000000000000000000000000000000000000000000000000000000000000
000000000000000101808181820100000000000000000000000000000000000000000000000000000000000000000000000000000000000000000000
000000000404018081949191938203040300000000000000000000000000000000000000000000030103030404040203020000000000000302010102
000000008081819491919191919381818200000000000000000000000104030000000000000000808181818181818181820000000000008081818181
00000000a0a1a1a1a1a1a1a1a1a1a1a1a20000000000000000000000a3a4a40000000000000000a0a1a1a1a1a1a1a18492040000000000a0a1a1a1a1
b1b1b1b1b1b1b1b1b1b1b1b1b1b1b1b1b1b1b1b1b1b1b1b20000000000000000000000b0b1b1b1b1b1b1b1b1b1b1b290938200000000000000000000
c1c1c1b3d1d1d1d1d1d1d1d1d1d1d1d1d1d1d1d1d1d1b4c2e5e600000000000000e3e4c0b3d1d1d1d1d1d1d1d1b4c290919203000000000000000000
c1c1c1c2101010101010101010101010101010101010c0c2f5f600000000000000f3f4c0c21010101010101010c0c290919382000000000000000000
c1c1c1c2101010101010101010101010101010101010d0d20000000002040400000000d0d21010101010101010c0c290919192030000000000000000
c1c1c1c21010171815161010171813141010171811121010000000018081820300000010101010101010101010c0c290919193820100000000000000
c1c1c1c21010272825261010272823241010272821221010040101809491938202030410101010101010101010c0c290919191938204040102020104
c1c1c1c2e0e1e1e1e1e1e1e1e1e1e1e1e1e1e1e1e1e1e1e28081819491919193818182e0e1e1e1e1e1e1e1e1e2c0c290919191919381818181818181

