83a1a1a1a200000000a0a1a1a1a1a1a1a1849191919191919191920000009083a1a1a1a1a1a1a1a1a1a1a1a1a184
a20000000000001010100000000000000090919191919191919192000000909200000000000000000000000000a0
00001010100000101010000000000000009091919191919191919200000090920000000000001010100000000000
00000000100000000010000000000000009091919191919191919200000090920000000000001010100000000000
00000000100000000000000000000000009091919191919191919200000090920000000000001010100000000000
82000000000000000000000000000000009091919191919191919200000090920000000000000000000000000080
92000000000000000000000000000000009091919191919191919200100090920000000080818181818181818194
9200000000000000000000000000000000a0a1a1a1a1a1a1a1a1a2101010a0a200000000a0a1a1a1a1a1a1a1a184
a20000000000000000000000000000000000000000000000000000100010000000000000000000101000000000a0
00001010000000000000000000000000000000000000000000000000000000000000000000001000000000000000
00001000000000000000000000000000000000000000000000000000000000000000000000001010100000000000
00101000000000000000000000000000000000000000000000000000000000000000000000001010100000000000
81818181818181818181818181818181818181820000008081818181818181818181818181818181818181818181
919191919191919191919191919191919191919200000090919191919183a1a1a1a1a1a1a1a1a1a1a1a1a1a1a1a1
a1a1a1a1a1a1a1a1a1a1a1a1a1a1a1a1a1a18492000000909191919183a200000000000000001010100000000000
00000000000000000000000000000000000090920000009091919183a20000000000000000000010100000000000
000000000000000000000000000000000000909200000090919183a2000000000000000000001010100000000000
0000101000000000000000808200000000009092000000909183a200000000000000000000000000000080818181
00000010000000000000009092000000000090920000009083a20000000000000000000000000000008094919191
0000001010000000000080949382000000009092000000a0a200000000000000000000000000000000a0a1a1a1a1
000000000000000000009091919200000000a0a20000000000000000000000000000000000000000100010000000
00000000000000000080949191938200000000000000000000000000000000000000000000808200101010000000
000000000000000000a0a1a1a1a1a200000000000000000000000000000000000000000000a0a200000010000000
b1b1b1b1b1b1b1b1b1b1b1b1b1b1b1b1b1b1b1b1b1b1b1b20000000000000000000000b0b1b1b1b1b1b1b1b1b1b1
c1c1c1b3d1d1d1d1d1d1d1d1d1d1d1d1d1d1d1d1d1d1b4c2e5e600004546470000e3e4c0b3d1d1d1d1d1d1d1d1b4
c1c1c1c2101010101010101010101010101010101010c0c2f5f600000000000000f3f4c0c22020202020202020c0
c1c1c1c2101007081010101007081010101007081010d0d20000000002040400000000d0d22020202020202020c0
c1c1c1c21010171815161010171813141010171811121010000000018081820300000020202020203031323334c0
c1c1c1c21010272825261010272823241010272821221010040101809491938202030420202020204041424344c0
c1c1c1c2e0e1e1e1e1e1e1e1e1e1e1e1e1e1e1e1e1e1e1e28081819491919193818182e0e1e1e1e1e1e1e1e1e2c0

door 18 27 2 2 101 10 9
door 12 27 2 2 201 3 9
door 6 27 2 2 301 3 9
edgedoor w 14 10 2 -14
edgedoor e 13 5 3 -11
edgedoor e 19 5 4 13
edgedoor w 8 5 5 -8
edgedoor e 8 5 6 -8
edgedoor w 0 6 7 0
edgedoor e 0 6 8 0
edgedoor n 0 20 9 0
edgedoor n 26 5 10 -26
hero 29 26
sprite 8 6 PlatformSprite 80 0 pencil
sprite 2 22 FlagSprite chest2
sprite 43 16 FlagSprite chest3
sprite 43 22 FlagSprite chest4
sprite 3 11 FlagSprite chest5
sprite 43 11 FlagSprite chest6
sprite 0 4 FlagSprite chest7
sprite 43 5 FlagSprite chest8
sprite 8 4 FlagSprite chest9
sprite 28 4 FlagSprite chest10
sprite 35 21 BreakableSprite
