ecececececececececececececececececececcf
9b000000000000000000000000000000000000db
ab000000000000000000000000000000000000db
ab000000f0f1f1f1f1f1f1f1f1f1f1f1f20000db
ab000000808200000000000000000000000000db
ab000000909200000000000000000000000000db
ab000000a0a200000000000000000000000000db
ab000000000000000000000000000000000000db
ab000000000000000000000000000606060604db
ab535455cbccccccccccccccccccccccccccccdf

sprite 6 8 ChestSprite chest10
edgedoor s 0 5 1 26
sprite 18 8 SwitchSprite stompbox unlock
sprite 4 7 BlockSprite unlock
