83a1a1a1a1a1a1a1a1a1a1a1a1a1a1a1a1a1a184
9200000000000000000000000000000000000090
9200000000000000000000000000000000000090
92000000f0f1f1f1f1f1f1f1f1f1f1f1f2000090
9200000080820000000000000000000000000090
9200000090920000000000000000000000000090
92000000a0a20000000000000000000000000090
9200000000000000000000000000000000000090
9200000002030304030204020101060606060190
9253545580818181818181818181818181818194

sprite 6 8 ChestSprite chest10
edgedoor s 0 5 1 26
sprite 18 8 SwitchSprite stompbox unlock
sprite 4 7 BlockSprite unlock
