83a1a1a1a1a1a1a1a1a1a1a1a1a1a1a1a1a1a184
92000000f0f1f200000000000000000000000090
9200000000000000000000000000000000000090
9200000000000000000000000000000000000090
9200000000000000000000000000000000000090
9200000000000000000000000000000000000090
9200000000000000000000000000000000000090
9200000000000000000000000000000000000090
9200000000000000000000000000000000000090
9245464780818181818181818181818181818194

sprite 9 8 ChestSprite chest10
edgedoor s 0 5 1 26
