b3d1d1d1d1d1d1d1d1d1d1d1d1d1d1d1d1d1d1b4
c2101010101010101010101010101010101010c0
c2101010101010101010101010101010101010c0
c2101010101010101010101010101010101010c0
c2101010101010101010101010101010101010c0
c2101010101010101010101010101010101010c0
c2100708101010101010101010101010101010c0
c2101718101010101010101010101010101010c0
d2102728101010101010101010101010101010d0
e0e1e1e1e1e1e1e1e1e1e1e1e1e1e1e1e1e1e1e2

door 2 7 2 2 1 19 28
