b3d1d1d1d1d1d1d1d1d1d1d1d1d1d1d1d1d1d1d1
c210101010101010101010101010101010101010
c210101010101010101010101010101010101010
c210101010101010101010101010b0b1b1b1b1b1
c210101010101010101010101010d0d1d1d1d1b4
c2101010101010101010101010101010101010c0
c2101010101010101010101010101010101010c0
c3b1b1b1b1b1b1b1b1b1b1b1b1b21010101010c0
c1c1c1c1c1c1c1c1c1c1c1c1c1c21010eb1010d0
c1c1c1c1c1c1c1c1c1c1c1c1c1c2e0e1e1e1e1e2

edgedoor e 0 10 101 0
sprite 4 1 CrusherSprite 5 1
sprite 9 5 CrusherSprite 5 -1
spawnAtEntranceOnly
