b3d1d1d1d1d1d1d1d1d1d1d1d1d1d1d1d1d1d1b4
c2383110103030313010313110103030311010c0
c2383031301031311010313031303030103010c0
c2383131303131103131101030313131301010c0
c2383031313031101030301010101030303131c0
c2381030383110103031b0b1b1b1b1b1b1b1b1c4
c2381010381031101030d0d1d1d1d1d1d1d1d1b4
c2383030381031103030103131103031303138c0
c2383030383131303131101030103010101038c0
c2381030381031313131303110303110103138c0
c2381031383110383838383838103131311038c0
c2383031381031313130303110103031103138c0
c2381010381031101030301031103131313038c0
c2383031381031303031313130101031313038c0
c2383031381030103110303838383838383838c0
c2383131383031303030101010103031103138c0
c2383030383131301010313030301030101038c0
c2381030383130301031303010301010103138c0
c2381010383838383838383110313130313038c0
c2381010383030311030311030303110313138c0
c2383031383110103031303130103010103038c0
c2381030383031311030103010311030103138c0
c2381031383131303131383838383838383838c0
c2381031383010303131313031313031303038c0
c2383110383130303110103110301030103138c0
c2383130381030103131103031303110103038c0
c2383130383838383838383830303010303038c0
c2383110381030313131303031313031103138c0
c2383110381031301031103131313131313038c0
c2383030381030303010103131103110311038c0
c2383031381010303838383838383830311038c0
c2383131381030303030313031313110101038c0
c23831313830103130301030303131103f1038c0
c23830103831313031311030101030304f1038c0
c23831303838383838383838383838105f3138c0
c3b23031b0b1b1b1b1b1b1b1b1b238306f3038c0
c1c23130d0d1d1d1d1d1d1d1d1d230307f1038c0
c1c231303031303131303031311031318f3138c0
c1c230101031313130311010103131309f3138c0
c1c3b1b1b1b1b1b235363637b0b1b1b1b1b1b1c4

edgedoor s 0 20 101 0
sprite 15 4 TattleSprite schoolBroom
sprite 14 4 SwitchSprite once _ schoolBroom
resetPermanent schoolBroom
itemConstraint broom schoolBroom
setPermanentStateOnDeath schoolBroom null
