b3d1d1d1d1d1d1d1d1d1d1d1d1d1d1d1d1d1d1b4
c2381010101010101010101010101010101010c0
c2381010101010101010101010101010101010c0
c2381010101010101010101010101010101010c0
c2381010101010101010101010101010101010c0
c2381010101010101010b0b1b1b1b1b1b1b1b1c4
c2381010101010101010d0d1d1d1d1d1d1d1d1b4
c2381010101010101010101010101010101038c0
c2381010101010101010101010101010101038c0
c2381010101010101010101010101010101038c0
c2381010103838383810101010101010101038c0
c2381010101010101010101010101010101038c0
c2381010101010101010101010101010101038c0
c2381010101010101010101010101010101038c0
c2381010101010101010101010101010101038c0
c2381010101010101010103838383810101038c0
c2381010101010101010101010101010101038c0
c2381010101010101010101010101010101038c0
c2383838383838101010101010101010101038c0
c2381010101010101010101010101010101038c0
c2381010101010101010101010101010101038c0
c2381010101010101010101010101010101038c0
c2381010101010101010383838383838101038c0
c2381010101010101010101010101010101038c0
c2381010101010101010101010101010101038c0
c2381010101010101010101010101010101038c0
c2381010103838383838383810101010101038c0
c2381010101010101010101010101010101038c0
c2381010101010101010101010101010101038c0
c2381010101010101010101010101010101038c0
c2381010103838383838383838383810101038c0
c2381010101010101010101010101010101038c0
c23810101010101010101010101010103f1038c0
c23810101010101010101010101010104f1038c0
c23838383838383838383838383838105f1038c0
c3b1b1b1b1b1b1b1b1b1b1b1b1b238106f1038c0
c1c1c1c1c1b3d1d1d1d1d1d1d1d210107f1038c0
c1c1c1c1c1c2101010101010101010108f1038c0
c1c1c1c1c1c2101010101010101010109f1038c0
c1c1c1c1c1c3b1b235363637b0b1b1b1b1b1b1c4

edgedoor s 0 20 101 0
sprite 15 4 TattleSprite schoolBroom
sprite 14 4 SwitchSprite once _ schoolBroom
resetPermanent schoolBroom
itemConstraint broom schoolBroom
setPermanentStateOnDeath schoolBroom null
