b3d1d1d1d1d1d1d1d1d1d1d1d1d1d1d1d1d1d1b4
c2381010101010101010101010101010101010c0
c2381010101010101010101010101010101010c0
c2381010101010101010101010101010101010c0
c2381010101010101010101010101010101010c0
c2381010101010101010b0b1b1b1b1b1b1b1b1c4
c2381010101010101010d0d1d1d1d1d1d1d1d1b4
c2381010101010101010101010101010101038c0
c2381010101010101010101010101010101038c0
c2381010101010101010101010101010101038c0
c2381010103838383810101010101010101038c0
c2381010101010101010101010101010101038c0
c2381010101010101010101010101010101038c0
c2381010101010101010101010101010101038c0
c2381010101010101010101010101010101038c0
c2381010101010101010103838383810101038c0
c2381010101010101010101010101010101038c0
c2381010101010101010101010101010101038c0
c2383838383838101010101010101010101038c0
c2381010101010101010101010101010101038c0
c2381010101010101010101010101010101038c0
c2381010101010101010101010101010101038c0
c2381010101010101010383838383838101038c0
c2381010101010101010101010101010101038c0
c2381010101010101010101010101010101038c0
c2381010101010101010101010101010101038c0
c2381010103838383838383810101010101038c0
c2381010101010101010101010101010101038c0
c2381010101010101010101010101010101038c0
c2381010101010101010101010101010101038c0
c2381010103838383838383838383810101038c0
c2381010101010101010101010101010101038c0
c2381010101010101010101010101010101038c0
c2381010101010101010101010101010101038c0
c2383838383838383838383838383810101038c0
c3b1b1b1b1b1b1b1b1b1b1b1b1b23810101038c0
c1c1c1c1c1b3d1d1d1d1d1d1d1d21010101038c0
c1c1c1c1c1c210101010101010101010101038c0
c1c1c1c1c1c210101010101010101010101038c0
c1c1c1c1c1c3b1b235363637b0b1b1b1b1b1b1c4

edgedoor s 0 20 101 0
sprite 15 4 TattleSprite schoolBroom
sprite 14 4 SwitchSprite once _ schoolBroom
resetPermanent schoolBroom
itemConstraint broom schoolBroom
setPermanentStateOnDeath schoolBroom null
