b3d1d1d1d1d1d1d2e0e1e1e2d0d1d1d1d1d1d1b4
c2101010101010101010101010101010101010c0
c2101010101010101010101010101010101010c0
c2101010101010101010101010101010101010c0
c2101010101010101010101010101010101010c0
c2101010101010101010101010101010101010c0
c2101010101010101010101010101010101010c0
c2101010101010101010101010101010101010c0
c2101010101010101010101010101010101010c0
c3b1b1b1b1b1b1b210101010b0b1b1b1b1b1b1c4

edgedoor s 0 20 101 0
