d1d1d1d1d1d1d1d1d1d1d1d1d1d1d1d1d1d1d1b4
10101010101010101010101010101010101038c0
10101010101010101010101010101010101038c0
b210101010101010101010b0b1b23810101038c0
c210101010101010101010c0c1c23810101038c0
c3b1b1b1b1b1b1b1b21010c0c1c23810101038c0
c1c1b3d1d1d1d1d1d21010c0c1c23810101038c0
c1c1c21010101010101010c0c1c23810101038c0
c1c1c21010eb1010101010c0c1c23810101038c0
c1c1c3b1b1b1b1b1b1b1b1c4c1c3b1b1b1b1b1c4

edgedoor w 0 10 101 0
spawnAtEntranceOnly
sprite 16 8 SwitchSprite stompbox unlock
sprite 9 7 BlockSprite unlock
