b3d1d1d1d1d1b4c1c1c1c1c1c1c1c1c1c1c1c1c1
c21010101010d0d1d1b4c1c1c1b3d1d1d1d1d1b4
c21010101010101010d0d1d1d1d21010101010c0
c2101010101010101010101010101010101010d0
c3b1b1b210101010101010101010101010101010
c1c1c1c2101010101010101010101010b0b21010
c1c1c1c2101010101010101010101010c0c3b1b1
c1c1c1c2101010101010101010101010c0c1c1c1
c1c1c1c21e1e1e1e1e1e1e1e1e1e1e1ec0c1c1c1
c1c1c1c3b1b1b1b1b1b1b1b1b1b1b1b1c4c1c1c1

edgedoor e 0 10 101 0
sprite 1 3 TattleSprite schoolVacuum
sprite 2 3 SwitchSprite once _ schoolVacuum
resetPermanent schoolVacuum
itemConstraint vacuum schoolVacuum
setPermanentStateOnDeath schoolVacuum null
