b3d1d1d1d1d1d1d1d1d1d1d1d1d1d1d1d1d1d1b4
c2101010101010101010101010101010101010c0
c2101010101010101010101010101010101010c0
c2101010101010101010101010101010101010d0
c210101010101010101010101010101010101010
c210101010101010101010101010101010101010
c2101010101010101010101010101010101010b0
c2101010101010101010101010101010101010c0
c2101010101010101010101010101010101010c0
c3b1b1b1b1b1b1b1b1b1b1b1b1b1b1b1b1b1b1c4

edgedoor e 0 10 101 0
