b3d1d1d1d1d1d1d1d1d1d1d1d1d1d1d1d1d1d1b4
c2101010101010101010101010101010101010c0
c210eb10101010101010101010101010101010c0
c3b1b1b2101010101010101010101010101010d0
c1c1c1c210101010101010101010101010101010
c1c1c1c210101010101010101010101010101010
c1c1c1c21e1e1e1e1e1e1e1e1e1e1e1e1e1eb0b1
c1c1c1c3b1b1b1b1b1b1b1b1b1b1b1b1b1b1c4c1
c1c1c1c1c1c1c1c1c1c1c1c1c1c1c1c1c1c1c1c1
c1c1c1c1c1c1c1c1c1c1c1c1c1c1c1c1c1c1c1c1

edgedoor e 0 10 101 0
