b3d1d210101010d0d1d1d1d1d1d1d1d1d1d1d1b4
c2101010101010101010101010101010101010c0
c2101035363637101010101010101010101010c0
c2101010101010101010105051521010101010c0
c2101010101010101010106061621010101010c0
c2101035363637101010107071721010101010c0
c2101010101010101010101010101010101010c0
c2101035363637101010101010101010101010c0
c2101010101010101010101010101010101010c0
c3b1b1b1b1b1b1b1b1b1b1b1b1b1b1b1b1b1b1c4

edgedoor n 0 20 101 0
sprite 2 1 TattleSprite schoolBell
resetPermanent schoolBell
itemConstraint bell schoolBell
setPermanentStateOnDeath schoolBell null
sprite 11 3 BellRevelatorSprite
