b3d1d210301031d0d1d1d1d1d1d1d1d1d1d1d1b4
c2103010101030313130311010313010303110c0
c2303035363637303010301030303010313130c0
c2303131311030101031105051523131313110c0
c2313110101031303130106061623131311030c0
c2101035363637313030107071723130313130c0
c2101010313030311031313010301030313010c0
c2311035363637301030101030303010303010c0
c2301010101010313110313031103130313031c0
c3b1b1b1b1b1b1b1b1b1b1b1b1b1b1b1b1b1b1c4

edgedoor n 0 20 101 0
sprite 2 1 TattleSprite schoolBell
resetPermanent schoolBell
itemConstraint bell schoolBell
setPermanentStateOnDeath schoolBell null
sprite 11 3 BellRevelatorSprite
