c1c1b3d1d1d1d1d1d1d1d1d1d1d1d1d1d1b4c1c1
c1b3d23031101030311031103031313010d0b4c1
b3d230103130311010313131301030313110d0b4
d2301031311010313030103130103130103130c0
30103110103031313010101030311010303110c0
30101031311030303010311030303110303030c0
b1b1b210103130303010303130103110b0b1b1c4
c1c1c210101030101030301010303031c0c1c1c1
c1c1c21e1e1e1e1e1e1e1e1e1e1e1e1ec0c1c1c1
c1c1c3b1b1b1b1b1b1b1b1b1b1b1b1b1c4c1c1c1

edgedoor w 0 10 101 0
sprite 18 5 TattleSprite schoolUmbrella
sprite 17 5 SwitchSprite once _ schoolUmbrella
resetPermanent schoolUmbrella
itemConstraint umbrella schoolUmbrella
setPermanentStateOnDeath schoolUmbrella null
