b3d1d1d1d1d1d1d1d1d1d1d1d1d1d1d1d1d1d1b4
c2101010101010101010101010101010101010c0
c2101010101010101010101010101010101010c0
d2101010101010101010101010101010101010c0
10101010101010101010101010101010101010c0
10101010101010101010101010101010101010c0
b2101010101010101010101010101010101010c0
c2101010101010101010101010101010101010c0
c2101010101010101010101010101010101010c0
c3b1b1b1b1b1b1b1b1b1b1b1b1b1b1b1b1b1b1c4

edgedoor w 0 10 101 0
