c1c1b3d1d1d1d1d1d1d1d1d1d1d1d1d1d1b4c1c1
c1b3d21010101010101010101010101010d0b4c1
b3d210101010101010101010101010101010d0b4
d2101010101010101010101010101010101010c0
10101010101010101010101010101010101010c0
10101010101010101010101010101010101010c0
b1b1b210101010101010101010101010b0b1b1c4
c1c1c210101010101010101010101010c0c1c1c1
c1c1c21e1e1e1e1e1e1e1e1e1e1e1e1ec0c1c1c1
c1c1c3b1b1b1b1b1b1b1b1b1b1b1b1b1c4c1c1c1

edgedoor w 0 10 101 0
sprite 18 5 TattleSprite schoolUmbrella
sprite 17 5 SwitchSprite once _ schoolUmbrella
resetPermanent schoolUmbrella
itemConstraint umbrella schoolUmbrella
setPermanentStateOnDeath schoolUmbrella null
