c1c1b3d1d1d1d1d1d1d1d1d1d1d1d1d1d1b4c1c1
c1b3d21010101010101010101010101010d0b4c1
b3d210101010101010101010101010101010d0b4
d2101010101010101010101010101010101010c0
10101010101010101010101010101010101010c0
101010101010101010101010101010101010ebc0
b1b1b21010101010101010101010101010b0b1c4
c1c1c21010101010101010101010101010c0c1c1
c1c1c21e1e1e1e1e1e1e1e1e1e1e1e1e1ec0c1c1
c1c1c3b1b1b1b1b1b1b1b1b1b1b1b1b1b1c4c1c1

edgedoor w 0 10 101 0
