c1b3d1d1d1d1d1d1d1d1d1d1d1d1d1d1d1d1d1b4
b3d21010101010101010101010101010101010c0
c2101010101010101010101010101010101010c0
c2101010101010101010101010101010101010c0
c2101010101010101010101010101010101010c0
c2101010101010101010101010101010101010c0
c2101010101010101010101010101010101010d0
c210101010101010101010101010101010101010
c210101010101010101010101010101010101010
c3b1b1b1b1b1b1b1b1b1b1b1b1b1b1b1b1b1b1b1

edgedoor e 0 10 101 0
