b3d1d1d1d1d1d1d1d1d1d1d1d1b4c1c1c1c1c1c1
c2101010101010381010101010c0c1c1c1c1c1c1
c2101010101010381010101010c0c1c1c1c1c1c1
c210eb10101010381010101010c0c1c1c1c1c1c1
c3b1b1b2381010381010381010d0d1d1d1d1b4c1
c1c1c1c23810103810103810101010101010d0b4
c1c1c1c2381010381010381010101010101010d0
c1c1c1c238101010101038101010101010101010
c1c1c1c23810101010103838383838b0b2101010
c1c1c1c3b1b1b1b1b1b1b1b1b1b1b1c4c3b1b1b1

edgedoor e 0 10 101 0
