b3d1d1d1d1d1d1d1d1d1d1d1d210101010d0d1b4
c2381010101010101010101010101035363637c0
c2381010101010101010101010101010101010c0
c238101010b0b1b1b1b1b1b1b1b1b1b2353637c0
c238101010d0d1d1d1d1d1d1d1d1b4c2101010c0
c238101010101010101010101010c0c2353637c0
c238101010101010101010101010c0c2101010c0
c238101010101010101010101010c0c2101010c0
c238101010101010101010101010c0c2353637c0
c2381010101010101010b0b1b1b1c4c2101010c0
c2381010101010101010c0c1c1c1c1c2101010c0
c2381010101010101010d0b4c1c1c1c2353637c0
c238101010101010101038c0c1c1c1c2101010c0
c238101010101010101038c0c1c1c1c2101010c0
c238101010101010101038c0c1c1c1c2353637c0
c238101010101010101038c0c1c1c1c2101010c0
c238101010101010101038c0c1c1c1c2101010c0
c238101010101010101038c0c1c1c1c2353637c0
c238101010101010101038c0c1c1c1c2101010c0
c238101010101010101038c0c1c1c1c2101010c0
c238101010101010101038c0c1c1c1c2353637c0
c238101010101010101038c0c1c1c1c2101010c0
c238101010101010101038c0c1c1c1c2101010c0
c238101010101010101038c0c1c1c1c2353637c0
c238101010101010101038c0c1c1c1c2101010c0
c238101010101010101038d0d1d1d1d2101010c0
c2381010101010101010101010101010353637c0
c2381010101010101010101010101010101010c0
c2381010101010101010101010101010101010c0
c3b1b1b1b1b1b1b1b1b1b1b1b1b1b1b1b1b1b1c4

edgedoor n 0 20 101 0
sprite 12 8 TattleSprite schoolGrapple
sprite 11 8 SwitchSprite once _ schoolGrapple
resetPermanent schoolGrapple
itemConstraint grapple schoolGrapple
setPermanentStateOnDeath schoolGrapple null
