c1c1c1c1c1c1c1c1c1c1c1c1c1b3d1d1d1d1d1b4
c1c1c1c1c1c1c1c1c1c1c1c1c1c21010101010c0
c1c1c1c1c1c1c1c1c1c1c1c1c1c21010101010c0
c1c1c1c1c1c1c1c1c1c1c1c1c1c21010101010c0
c1c1b3d1d1d1d1d1d1d1d1d1d1d210101010ebc0
b3d1d21010101010101010101010101038b0b1c4
d210101010101010101010101010101038c0c1c1
1010101010101010101010101010101038c0c1c1
1010101010b0b1b1b21e1e1e1e1e1e1eb0c4c1c1
e0e1e1e1e2c0c1c1c3b1b1b1b1b1b1b1c4c1c1c1

edgedoor w 0 10 101 0
