c1c1c1c1c1c1c1c1c1c1c1c1c1b3d1d1d1d1d1b4
c1c1c1c1c1c1c1c1c1c1c1c1c1c23130313110c0
c1c1c1c1c1c1c1c1c1c1c1c1c1c23031311031c0
c1c1c1c1c1c1c1c1c1c1c1c1c1c21031303131c0
c1c1b3d1d1d1d1d1d1d1d1d1d1d23110303010c0
b3d1d23131101031101030301031101038b0b1c4
d231103131313130101030103010301038c0c1c1
1010311030311031103130103031313138c0c1c1
3131103110b0b1b1b21e1e1e1e1e1e1eb0c4c1c1
e0e1e1e1e2c0c1c1c3b1b1b1b1b1b1b1c4c1c1c1

edgedoor w 0 10 101 0
sprite 18 4 TattleSprite schoolRaft
sprite 17 4 SwitchSprite once _ schoolRaft
resetPermanent schoolRaft
itemConstraint raft schoolRaft
setPermanentStateOnDeath schoolRaft null
