83a1a1a1a1a1a1a1a1a1a1a1a1a1a1a1a1a1a1a1
9200000000000000000000000000000000000000
920000000000000000000000000000f0f1f20000
9200000000000000000000000000000000000000
9200000000000000000000000000000000000000
9200000000000000000000000000000000000000
9200000000000000000000000000000000000000
9200000000000000000000000000000000000000
a200000000000000000000000000000000000000
b1b1b1b1b1b1b1b1b1b1b1b1b1b1b1b1b1b1b1b1

edgedoor e 0 10 1 14
sprite 2 8 ChestSprite chest2
