83a1a1a1a1a1a1a1a1a1a1a1a1a1a1a1a1a1a1a1a1a1a1a1a1a1a1a1a1a1
920000000000000000000000000000000000000000000000000000000000
920000000000000000000000000000000000000000000000000000000000
92000000000000f0f1f1f1f1f1f1f1f1f1f1f1f1f1f1f1f1f20000000053
92010300000000000000000000000000000000000000004d4e0000000000
93818200000000000000000000000000000000000000005d5e0000000000
919192020200000000000000000000000d0000000000006e4d4e00000000
919193818200000000000000000000001d0000000000007e5d5e00000000
a1a1a1a1a206060606060606060606062d0000000000004d4e4d4e000000
4e4d4e4d4e4d4e4d4e4d4e4d4e4d4e4d4e4d4e4d4e4d4e5d5e5d5e4d4eb1

edgedoor e 0 10 1 14
sprite 17 8 ChestSprite chest2
sprite 4 6 PlatformSprite 80 0 pencil
