83a1a1a1a1a1a1a1a1a1a1a1a1a1a1a1a1a1a1a1a1a1a1a1a1a1a1a1a1a1
920000000000000000000000000000000000000000000000000000000000
920000000000000000000000000000000000000000000000000000000000
92000000000000d4d3d3d3d4d3d3d4d4d4d3d4d3d4d3d3b0b20000000000
9200000000000000000000000000000000000000000000c0c20000000000
9381820000000000000000000000000000000000000000c0c3b200000000
919192000000000000000000000000000d000000000000c0c1c200000000
919193818200000000000000000000001d000000000000c0c1c3b2000000
a1a1a1a1a206060606060606060606062d000000000000c0c1c1c2000000
b1b1b1b1b1b1b1b1b1b1b1b1b1b1b1b1b1b1b1b1b1b1b1c4c1c1c3b1b1b1

edgedoor e 0 10 1 14
sprite 17 8 ChestSprite chest2
sprite 4 6 PlatformSprite 80 0 pencil
