b3d1d1d1d1d1d1d1d1d1d1d1d1d1d1d1d1d1d1d1
c210101010101010101010101010101010101010
c210101010101010101010101010101010101010
c210101010101010101010101010101010101010
c210101010101010101010101010b0b1b1b1b1b1
c210101010101010101010101010c0c1c1c1c1c1
c210070810101010101010101010c0c1c1c1c1c1
c210171810101010101010101010c0c1c1c1c1c1
d210272810101010101010101010d0d1d1d1d1d1
e0e1e1e1e1e1e1e1e1e1e1e1e1e1e1e1e1e1e1e2

door 2 7 2 2 1 13 29
