c1c1c1c1c1c1b3d1d1d1d1b4c1c1c1c1b3d1d1d1
c1c1c1c1c1b3d210301031d0b4c1c1b3d2101010
c1c1c1c1b3d2301031311010d0b4b3d231313110
c1c1b3d1d23130303031101031d0d23130103010
c1b3d2103030103010311010103110303131b0b1
b3d2103010101030b0b23131311030301010c0c1
c210070830301030c0c23030303031311031c0c1
c210171810090a10c0c230313110300b0c10c0c1
d210272831191a30d0d210303030311b1c10d0d1
e0e1e1e1e1e1e1e1e1e1e1e1e1e1e1e1e1e1e1e2

door 2 7 2 2 1 13 29
edgedoor e 0 10 202 0
resetPermanent schoolJump
itemConstraint all schoolJump
sprite 3 4 TattleSprite schoolJump
