c1c1c1c1b3d1d1d1d1d1d1d1d1b4b3d1d1d1d1d1
c1c1c1c1c21010101010101010c0c21010101010
c1c1c1c1c21010101010101010c0c21010101010
c1c1c1c1c21010101010101010c0c21010101010
c1c1c1c1c21010101010101010c0c2101010b0b1
b3d1d1d1d2101010b0b2101010c0c2101010c0c1
c210070810101010c0c2101010d0d2101010c0c1
c210171810090a10c0c210101010100b0c10c0c1
d210272810191a10d0d210101010101b1c10d0d1
e0e1e1e1e1e1e1e1e1e1e1e1e1e1e1e1e1e1e1e2

door 2 7 2 2 1 13 29
edgedoor e 0 10 202 0
