d238101038d0d1d1d1d1d1d1d1d1d1d1d1d1d1b4
10101010101010100d10101010101010101010c0
10101010102b2c101d101010101010292a1010c0
10101010101010102d10101010101010101010c0
b1b1b1b1b1b1b1b1b1b1b1b1b2363636363636c0
c1c1c1c1c1c1c1c1c1c1c1c1c2101010101010c0
c1c1c1c1c1c1c1c1c1c1c1c1c2101010101010d0
c1c1c1c1c1c1c1c1c1c1c1c1c3b1b1b210101010
d1d1d1d1d1d1d1d1d1d1d1d1d1d1d1d210101010
e0e1e1e1e1e1e1e1e1e1e1e1e1e1e1e1e1e1e1e2

edgedoor w 0 10 201 0
edgedoor e 0 10 203 0
edgedoor n 0 20 205 0
