d238313138d0d1d1d1d1d1d1d1d1d1d1d1d1d1b4
31313030303130100d31103030313030303130c0
10103130102b2c301d303010311031292a3030c0
30311030313110102d30101030311031101031c0
b1b1b1b1b1b1b1b1b1b1b1b1b2353636363637c0
c1c1c1c1c1c1c1c1c1c1c1c1c2301031301030c0
c1c1c1c1c1c1c1c1c1c1c1c1c2103131301031d0
c1c1c1c1c1c1c1c1c1c1c1c1c3b1b1b230103131
d1d1d1d1d1d1d1d1d1d1d1d1d1d1d1d231313031
e0e1e1e1e1e1e1e1e1e1e1e1e1e1e1e1e1e1e1e2

edgedoor w 0 10 201 0
edgedoor e 0 10 203 0
edgedoor n 0 20 205 0
itemConstraint all schoolJump
sprite 13 6 TattleSprite schoolJump
