c1c1c1c1c1c1c1c1c1c1c1c1c1c1c1c2101010c0
c1c1c1c1c1c1c1c1c1c1c1c1c1c1c1c2101010c0
c1c1c1c1b3d1d1d1d1d1d1b4c1c1c1c2101010c0
b3d1d1d1d20e0e0e0e0e0ed0d1b4c1c2101010c0
c2101010101010101010101010d0d1d2100f10c0
c2101010101010101010101010101010101f10c0
d210102e2f1010101010101010101010101010c0
10101010101010101010101010b0b1b1b1b1b1c4
101010b0b21e1e1e1e1e1eb0b1c4c1c1c1c1c1c1
e0e1e2c0c3b1b1b1b1b1b1c4c1c1c1c1c1c1c1c1

edgedoor w 0 10 202 0
edgedoor n 0 20 204 0
