c1c1c1c1c1c1c1c1c1c1c1c1c1c1c1c2103131c0
c1c1c1c1c1c1c1c1c1c1c1c1c1c1c1c2301030c0
c1c1c1c1b3d1d1d1d1d1d1b4c1c1c1c2103010c0
c1c1b3d1d20e0e0e0e0e0ed0d1b4c1c2101010c0
b3d1d230313130103130303030d0d1d2300f31c0
c2101010303110103030101031303010101f30c0
d230302e2f1031313030103131303031103131c0
31103031103131313031101031b0b1b1b1b1b1c4
103130b0b21e1e1e1e1e1eb0b1c4c1c1c1c1c1c1
e0e1e2c0c3b1b1b1b1b1b1c4c1c1c1c1c1c1c1c1

edgedoor w 0 10 202 0
edgedoor n 0 20 204 0
itemConstraint all schoolJump
sprite 1 5 TattleSprite schoolJump
