c1c1c1c1c1c1c1c1c1c1c1c1c1c1c1c1c1c1c1c1
c1c1c1c1c1c1c1c1c1c1c1c1c1c1c1c1c1c1c1c1
c1c1c1c1b3d1d1d1d1d1d1b4c1c1c1c1c1c1c1c1
b3d1d1d1d20e0e0e0e0e0ed0d1d1d1d1d1d1d1b4
c2101010101010101010101010101010101010c0
c2101010101010101010101010101010101010c0
d210102e2f1010101010101010101010101010c0
10101010101010101010101010101010101010c0
101010b0b21e1e1e1e1e1eb0b1b1b1b1b1b1b1c4
e0e1e2c0c3b1b1b1b1b1b1c4c1c1c1c1c1c1c1c1

edgedoor w 0 10 202 0
