b3d1d1d1d1d1d1d1d1d1d1d1d1d1d1d1d1d1d1b4
c2101010101010101010101010101010101010c0
c2101010101010101010101010101010101010c0
c2101010101010101010101010101010101010c0
c3b1b1b1b1b1b1b1b1b1b1b1b1b1b1b2101010c0
c1c1c1c1c1c1c1c1c1c1c1c1c1c1c1c2101010c0
c1c1c1c1c1c1c1c1c1c1c1c1c1c1c1c2101010c0
c1c1c1c1c1c1c1c1c1c1c1c1c1c1c1c2101010c0
c1c1c1c1c1c1c1c1c1c1c1c1c1c1c1c2101010c0
c1c1c1c1c1c1c1c1c1c1c1c1c1c1c1c2101010c0

edgedoor s 0 20 203 0
