c1c1c1c1c1c1c1c1b3d1d1d1d1d1d1d1d1d1d1b4
c1c1c1c1c1c1c1c1c210101010101010101010c0
c1c1c1c1c1c1c1c1c2103d1010101010101010c0
c1c1c1c1c1c1c1c1c210101010101010101010c0
d1d1d1d1d1b4c1c1c21010b0b1b1b1b2101010c0
1010101010c0c1c1c21010c0c1c1c1c2101010c0
1010101010d0d1d1d21010c0c1c1c1c2101010c0
1010101010101010101010c0c1c1c1c2101010c0
1010101010101010101010c0c1c1c1c2101010c0
b1b1b1b1b1b1b1b1b1b1b1c4c1c1c1c2101010c0

edgedoor s 0 20 203 0
edgedoor w 0 10 205 0
sprite 9 7 BreakableSprite
itemConstraint all schoolJump
sprite 4 5 TattleSprite schoolJump
