c1c1c1c1c1c1c1c1b3d1d1d1d1d1d1d1d1d1d1b4
c1c1c1c1c1c1c1c1c231103030301031313110c0
c1c1c1c1c1c1c1c1c2103d3110313031303130c0
c1c1c1c1c1c1c1c1c231311030301010313031c0
d1d1d1d1d1b4c1c1c23031b0b1b1b1b2301010c0
3110101030c0c1c1c21030c0c1c1c1c2103030c0
3131303110d0d1d1d23030c0c1c1c1c2303030c0
3010103031303030303010c0c1c1c1c2101031c0
1010311030313010103131c0c1c1c1c2301010c0
b1b1b1b1b1b1b1b1b1b1b1c4c1c1c1c2303010c0

edgedoor s 0 20 203 0
edgedoor w 0 10 205 0
sprite 9 7 BreakableSprite
itemConstraint all schoolJump
sprite 4 5 TattleSprite schoolJump
