b3d1d1d1d1d1d1d1d1d1d1d1d1d1d1d1d1d1d1b4
c2101010101010101010101010101010101010c0
c210101010101010393a3b3c10101010101010c0
c210101010101010494a4b4c10101010101010c0
c3b21010b0b1b210595a5b5c10b0b1b2101010c0
b3d21010d0b4c210696a6b6c10c0c1c2101010c0
c238101038c0c2101010101010c0c1c2101010c0
c238101038c0c3b1b1b1b1b1b1c4c1c2101010c0
c238101038c0c1c1c1c1c1c1c1c1c1c2101010c0
c238101038c0c1c1c1c1c1c1c1c1c1c2101010c0

edgedoor s 0 20 203 0
