b3d1d1d1d1d1d1d1d1d1d1d1d1d1d1b4c1c1c1c1
c23810101010101010101010101010d0d1b4c1c1
c238101010101010393a3b3c1010101010d0b4c1
c238101010101010494a4b4c101010101010d0b4
c2381010b0b1b210595a5b5c10101010101010d0
c2381010d0b4c210696a6b6c1010101010101010
c238101038c0c210101010101010101010101010
c238101038c0c3b1b1b1b1b1b210101010101010
c238101038c0c1c1c1c1c1c1c3b1b1b210101010
c238101038c0c1c1c1c1c1c1c1c1c1c3b1b1b1b1

edgedoor s 0 20 202 0
edgedoor e 0 10 204 0
sprite 8 2 ProximityRevealSprite
