83a1a1a1a1a1a1a1a1a1a1a1a1a1a1a1a1a1a1a1a1a1a1a1a1a1a1a1a1a1a1a1a1a1a1a1a1a1a1a1a1a1a1a1a1a1a1a1a184
9200000000000000000000000000000000000000000000000000000000000000000000000000000000000000000000000090
a200000000000000000000000000000000000000000000000000000000000000000000000000000000000000000000000090
0000000000000000000000000000000000000000000000000000000000000000010200000000000000000000000000000090
0000000001020000000000030100000000000000040200000000000102000000808200000000000000000000000000000090
0104030380820000000000808200000000000000808200000000008082000000909200000000000302020300000000000090
8181818194920000000000909200000000000000909200000000009092000000909200000000008081818200000000000090
9191919191920000000000909200000000000000909200000000009092000000909200000000009091919200000000000090
9191919191920505050505909205050505050505909205050505059092050505909205050505059091919202030201030290
9191919191938181818181949381818181818181949381818181819493818181949381818181819491919381818181818194

edgedoor w 2 5 1 11
sprite 43 8 ChestSprite chest3
