83a1a1a1a1a1a1a1a1a1a1a1a1a1a1a1a1a1a184
92f0f1f200000000000000000000000000000090
a200000000000000000000000000000000000090
0000000000000000000000000000000000000090
0000000000000000000000000000000000000090
0000000000000000000000000000000000000090
8200000000000000000000000000000000000090
9200000000000000000000000000000000000090
9200000000000000000000000000000000000090
9381818181818181818181818181818181818194

edgedoor w 2 5 1 11
sprite 10 8 ChestSprite chest3
