83a1a1a1a1a1a1a1a1a1a1a1a1a1a1a1a1a1a1a1a1a1a1a1a1a1a1a1a1a1a1a1a1a1a1a1a1a1a1a1a1a1a1a1a1a1a1a1a184
9200000000000000000000000000000000000000000000000000000000000000000000000000000000000000000000000090
a200000000000000000000000000000000000000000000000000000000000000000000000000000000000000000000000090
0000000000000000000000000000000000000000000000000000000000000000000000000000000000000000000000000090
0000000000000000000000000000000000000000000000000000000000000000a5a600000000000000000000000000000090
01040303a5a60000000000a5a600000000000000a5a60000000000a5a6000000b5b600000000000302020300000000000090
81818181b5b60000000000b5b600000000000000b5b60000000000b5b6000000c5c600000000008081818200000000000090
91919191c5c60000000000c5c600000000000000c5c60000000000c5c6000000d5d600000000009091919200000000000090
91919191d5d60505050505d5d605050505050505d5d60505050505d5d6050505d5d605050505059091919202030201030290
91919191d5d68181818181d5d681818181818181d5d68181818181d5d6818181d5d681818181819491919381818181818194

edgedoor w 2 5 1 11
sprite 43 8 ChestSprite chest3
