c1c1c1c1c1c1c1c1c1c1c1c1c1c1c1c1c1c1c1c1
c1c1c1c1c1c1c1c1c1c1c1c1c1c1c1c1c1c1c1c1
c1c1c1c1c1c1c1c1c1c1c1c1c1c1c1c1c1c1c1c1
c1c1c1c1c1c1c1c1c1c1c1c1c1c1c1c1c1c1c1c1
b3d1d1d1d1d1d1d1d1d1b4c1c1c1c1c1c1c1c1c1
c2103030313110103010c0c1c1c1c1c1c1c1c1c1
c2100708101031313110c0c1c1c1c1c1c1c1c1c1
c2311718311031301010c0c1c1c1c1c1c1c1c1c1
d2312728313010103110d0d1d1d1d1d1d1d1d1d1
e0e1e1e1e1e1e1e1e1e1e1e1e1e1e1e1e1e1e1e2

door 2 7 2 2 1 7 29
sprite 7 8 GoodySprite
