c1c1c1c1c1c1c1c1c1c1c1c1c1c1c1c1c1c1c1c1
c1c1c1c1c1c1c1c1c1c1c1c1c1c1c1c1c1c1c1c1
c1c1c1c1c1c1c1c1c1c1c1c1c1c1c1c1c1c1c1c1
c1c1c1c1c1c1c1c1c1c1c1c1c1c1c1c1c1c1c1c1
b3d1d1d1d1d1d1d1d1d1b4c1c1c1c1c1c1c1c1c1
c2101010101010101010c0c1c1c1c1c1c1c1c1c1
c2100708101010101010c0c1c1c1c1c1c1c1c1c1
c2101718101010101010c0c1c1c1c1c1c1c1c1c1
d2102728101010101010d0d1d1d1d1d1d1d1d1d1
e0e1e1e1e1e1e1e1e1e1e1e1e1e1e1e1e1e1e1e2

door 2 7 2 2 1 7 29
sprite 7 8 GoodySprite
