919191919183a1a1a1a1a1a1a184919191919191
9191919183a200000000000000a0849191919191
91919183a2000000000000000000a08491919191
919183a20000000000000000000000a084919191
9183a200000000000000000000000000a0849191
83a2000000000000000000000000000000a08491
920000000000000000000000000000000000a084
9200000000000000000000000000000000000090
9200000000000001030204040300000000000090
9200000000000080818181818200000000000090
92000000000000a084919183a200005355000090
9200000000000000a08483a20000000000000090
9200000000000000009092000000000000000090
9200000000000000009092000000000000000090
9200000000000000009092000000000000000090
9204040103000000009092000000000000000090
9381818182000000009092000000000000000090
83a1a1a1a2000000009092000000000000000090
9200000000000000009092000000000000000090
9200000000000000009092000000000000000090
9200000000000000009092000000000000000090
9200000000000000009092000000000000000090
9200000000020404049092000000000000000090
9200000000808181819492000000000000000090
9200000000a0a1a1a18492000000000000000090
9200000000000000009092000000000000000090
9200000000000000009092000000000000000090
9200000000000000009092000000000000000090
9203010401000000009092000000000000000090
9381818182000000009092000000000000000090
83a1a1a1a2000000009092000000000000000090
9200000000000000009092000000000000000090
a200000000000000009092000000000000000090
0000000000000001039092000000000000000090
0000010200000080819492000000000000000090
04048082000000a0a1a1a2000000000000000090
8181949202000000000000000000000000000090
9191919382000000000000000000000000000090
9191919192010302010303040202040102020290
9191919193818181818181818181818181818194

edgedoor w 32 5 1 -13
sprite 7 8 ChestSprite chest4
sprite 11 13 PlatformSprite 140 0 pencil
sprite 13 16 PlatformSprite -130 0 pencil
sprite 15 19 PlatformSprite 120 0 pencil
sprite 17 22 PlatformSprite -110 0 pencil
sprite 15 25 PlatformSprite 100 0 pencil
sprite 13 28 PlatformSprite -90 0 pencil
sprite 11 31 PlatformSprite 80 0 pencil
sprite 14 34 PlatformSprite -70 0 pencil
