83a1a1a1a1a1a1a1a1a1a1a1a1a1a1a1a1a1a184
9200000000000000000000000000000000000090
a200000000000000000000000000000000000090
0000000000000000000000000000000000000090
0000000000000000000000000000000000000090
0000000000000000000000000000000000000090
8200000000000000000000000000000000000090
9200000000000000000000000000000000000090
92f0f1f200000000000000000000000000000090
9381818181818181818181818181818181818194

edgedoor w 2 5 1 17
sprite 12 8 ChestSprite chest4
