83a1a1a1a1a1a1a1a1a1a1a1a1a1a1a1a1a1a1a1
9200000000000000000000000000000000000000
9200000000000000000000000000000000000000
9200000000000000000000000000000000000000
9200000000808206060606060606808181818181
9245470000909381818181818181949191919191
9200000000a0a1a1a1a1a1a1a1a1a1a1a1a1a184
9200000000000000000000000000000000000090
9200000000000000000000000000000000000090
9381820000a3a4a3a4a4a3a3a4a3808182000090
9191920000000000000000000000909192000090
9191920000000000000000000000a0a1a2000090
9191920000000000000000000000000000000090
83a1a20000000000000000000000000000000090
9200000000808200000000000000000000000090
9200000000a0a200000000000000000000000090
9245464646464646464647808206060606060690
9200000000000006060606909381818181818194
9381818182000080818181949191919191919191
91919183a20000a0a1a1a1a1a1a1a18491919191
919183a20000000000000000000000a084919191
91919200004547000000000000000000a0849191
9191920000000000000000000000000000909191
9191920000000000000000000000000000909191
9191938181818181818181818181818181949191

sprite 7 23 ChestSprite chest5
edgedoor e 0 5 1 8
sprite 3 4 CrusherSprite 2 1
sprite 7 14 PlatformSprite 80 0 pencil
sprite 10 14 BreakableSprite
