83a1a1a1a1a1a1a1a1a1a1a1a1a1a1a1a1a1a1a1
920000000000000000000000f0f1f20000000000
9200000000000000000000000000000000000000
9200000000000000000000000000000000000000
9200000000000000000000000000000000808181
9200000000000000000000000000008081949191
9200000000000000000000000080819491919191
9200000000000000000000808194919191919191
9200000000000000008081949191919191919191
9381818181818181819491919191919191919191

sprite 3 8 ChestSprite chest5
edgedoor e 0 5 1 8
