a1a1a1a1a1a18483a1a1a1a1a1a1a1a1a1a1a184
0000000000009092000000000000000000000090
0000000000009092000000000000000000000090
0000000000009092000000f0f1f2000000000090
8245464646479092000000000000000000000090
9200000000009092000000000000000000000090
924546464647a0a2000000000000000000000090
9200000000000000000000000000000000000090
9200000000000000000000000000000000000090
9381818181818181818181818181818181818194

sprite 12 8 ChestSprite chest6
edgedoor w 0 5 1 8
