a1a1a1a1a1a1a1a1a1a1a1a1a1a1a1a1a1a1a184
00000000000d0000000000000000000000000090
00000000001d0000000000000000000000000090
00000000001d0000000000000000000000000090
82454646471d0000000000000000000000000090
92000000001d0000000000000000000000000090
92454646471d0000000000000000000000000090
92000000001d0000000080818181818200000090
92000000001d0000000090919191919200000090
92000000001d0000000090919191919245464790
92000000001d0000000090919191919200000090
92000000001d0000000090919191919200000090
92000000001d0000000090919191919245464790
92000000001d0000000090919191919200000090
92000000001d0000000090919191919200000090
92000000001d0000000090919191919245464790
92000000002d0000000090919191919200000090
9200000000808200000090919191919200000090
9200000000a0a2000000a0a1a1a1a1a245464790
9200000000000000000000000000000000000090
9200000000000000000000000000000000000090
9200000000000000000000000000000080818194
920000000000a30000a3000000a30000a0a1a184
9205050505050505050505050505050505050590
9381818181818181818181818181818181818194

sprite 10 6 ChestSprite chest6
edgedoor w 0 5 1 8
