a1a1a1a1a1a1a1a1a1a1a1a1a1a1a1a1a1a1a184
00000000000d0000000000000000000000000090
00000000001d0000000000000000000000000090
02000000001d0000000000000000000000000090
82535454551d0000000000000000000000000090
92000000001d0000000000000000000000000090
92454646471d0000000003030201020200000090
92000000001d0000000080818181818200000090
92000000001d0000000090919191919200000090
92000000001d0000000090919191919245464790
92000000001d0000000090919191919200000090
92000000001d0000000090919191919200000090
92000000001d0000000090919191919245464790
92000000001d0000000090919191919200000090
92000000001d0000000090919191919200000090
92000000001d0000000090919191919245464790
92000000002d0000000090919191919200000090
92000000004d4e00000090919191919200000090
92000000005d5e000000a0a1a1a1a1a245464790
9200000000000000000000000000000000000090
9200000000000000000000000000000002030190
9200000000000000000000000000000080818194
9200000000003e00003e0000003e0000a0a1a184
9205050505050505050505050505050505050590
9381818181818181818181818181818181818194

sprite 10 6 ChestSprite chest6
edgedoor w 0 5 1 8
