83a1a1a1a1a1a1a1a1a1a1a1a1a1849191919191
9248484848484848484848484848a0a1a1a1a1a1
9200000000000000000000000000000000000000
9200000000000000000000000000000000000000
92000000000000000000000000000000000d0002
92000000000000000000000000000000002d0080
9200000000000000000000000000000045464790
9200000000000000000000000000000000000090
9200000000000000010300000000030101000090
9245464646464647808205050505808182000090
9200000000000000909381818181949192000090
9200000000000000a0a1a1a1a1a1a18492000090
9245464646464647000000000000009092000090
920000000000000000000000000000a0a2000090
9200000000000000000000000000000000000090
9253545454545455000000000000000000000090
9200000000000000000000000000000000000090
9200000000000000000000000000000204030290
9205050505050505050505050505058081818194
9381818181818181818181818181819491919191

sprite 2 8 ChestSprite chest7
edgedoor e 0 6 1 0
sprite 9 5 CrusherSprite 6 1
sprite 4 17 PlatformSprite 80 0 pencil
