83a1a1a1a1a1a1a1a1a1a1a1a1a1a1a1a1a1a184
92000000000000000000000000000000000000a0
9200000000000000000000000000000000000000
9200000000000000000000000000000000000000
920000000000000000000000f0f1f20000000000
9200000000000000000000000000000000000080
9200000000000000000000000000000000000090
9200000000000000000000000000000000808194
9200000000000000000000000000000000909191
9381818181818181818181818181818181949191

sprite 2 8 ChestSprite chest7
edgedoor e 0 6 1 0
