83a1a1a1a1a1a1a1a1a1a1a1a1a1849191919191
a200000000000000000000000000a0a1a1a1a184
0000000000000000000000000000000000000090
0000000000000000000000000000000000000090
0200000000000000000000000000000000000090
8200000000000000000000000d00000000000090
9200000000000000000000001d00000000000090
924546470d000000000000001d00000000000090
920000001d000000000000001d01020201040490
924546471d050505050505051d80818181818194
920000001d808181818181821d90919191919191
924546471d909191919191921d90919191919191
920302032d909191919191922d90919191919191
938181818194919191919193819491a1a1a1a184

sprite 13 8 ChestSprite chest8
edgedoor w 0 6 1 0
sprite 14 2 BlockSprite unlock
sprite 2 12 SwitchSprite stompbox unlock
sprite 16 3 PlatformSprite 80 0 pencil
