91919191919191919191919183a1a1a1a1a1a184
a1a1a1a1a1a1a1a1a1a1a1a1a200000000000090
000000000000f0f1f20000000000000000000090
0000000000000000000000000000000000000090
0000000000000000000000000000000000000090
8200000000000000000000000000000000000090
9200000000000000000000000000000000000090
9381820000000000000000000000000000000090
9191920000000000000000000000000000000090
9191938181818181818181818181818181818194

sprite 5 8 ChestSprite chest8
edgedoor w 0 6 1 0
