83a1a1a1a1a1a1a1a1a1a1a1a1a1a1a1a1a1a184
9200000000000000000000000000000000000090
9200000000000000000000000000000000000090
9200000000000000000000000000000000000090
9200000000000000000080818200000000000090
9200000000000080820090919245464646464790
92000000000000a0a20090919200000000000090
9200808200000000000090919200000000000090
9200a0a200000006060090919245464646464790
9200000000000080820090919200000000000090
92000606000000a0a20090919200000000000090
9200808200000000000090919245464646464790
9200a0a200000006060090919200000000000090
9200000000000080820090919200000000000090
92000606000000a0a20090919245464646464790
9200808200000000000090919200000000000090
9200a0a200000000000090919200000000000090
9200000000000000000090919200000000000090
9200000000000000000090919200000000000090
9381818181824546464790919381818181818194

sprite 13 18 ChestSprite chest9
edgedoor s 0 20 1 0
