83a1a1a1a1a1a1a1a1a1a1a1a1a1a1a1a1a1a184
9200000000000000000000000000000000000090
9200000000000000000000000000000000000090
9200000000000000000004020300000000000090
9200000000000000000080818200000000000090
92000000000000797a0090919245464646464790
92000000000000898a0090919200000000000090
9200878800000000000090919200000000000090
9200979800000006060090919245464646464790
9200000000000085860090919200000000000090
9200060600000095960090919200000000000090
9200676800000000000090919245464646464790
9200777800000006060090919200000000000090
9200000000000065660090919200000000000090
9200060600000075760090919245464646464790
9200636400000000000090919200000000000090
9200737400000000000090919200000000000090
9200000000000000000090919200000000000090
9202040401030000000090919202040404030490
9381818181824546464790919381818181818194

sprite 13 18 ChestSprite chest9
edgedoor s 0 20 1 0
