83a1a1a1a1a1a1a1a1a1a1a1a1a1a1a1a1a1a184
9200000000000000000000000000000000000090
9200000000000000000000000000000000000090
9200000000000000000000000000000000000090
920000000000000000000000f0f1f20000000090
9200000000000000000000000000000000000090
9200000000000000000000000000000000000090
9382000000000000000000000000000000000090
9192000000000000000000000000000000000090
9193818181824546464780818181818181818194

sprite 13 8 ChestSprite chest9
edgedoor s 0 20 1 0
